R 1050 1800

NO ./path_to_the_north_texture
SO ./path_to_the_south_texture
WE ./path_to_the_west_texture
EA ./path_to_the_east_texture
S ./path_to_the_sprite_texture
F 220,100,200
C 225,30,15




         1111111111111
         1000000000001
1111111111000000000001
1100000000000000000001
1100000011100000000001
1100000011100000000001
1000000011000000000001
1000000010000000000N01
1100000000000000000001
1100000000000000000001
1100000000000000000001
1100000000000111110001
1100000000000011100001
1100000000000001000001
1100000000000000000001111111111111111
1100000000000000000000000000000000001
1100000000000000000000001111111111111
1111111111111111111111111
